111111111111111111111111111111
1X000000000000P0000000000000X1
11111000C0000000000000C0011111
111111000000000000000000111111
111111000000000000000000111111
111111000000000000000000111111
111111111111100011111111111111
111110000000000000000000011111
100000000000011100000000000001
10000000000001E100000000000001
100000000000000000000000000001
100000000000000000000000000001
111111111111110111111111111111
111111111000110110001111111111
111111111010000000101111111111
111111111011111111101111111111
111111111011111111101111111111
111111111X111111111X1111111111
111111111111111111111111111111