111111111111111111111111111111
10000000000000P000000000000001
11111000C0000000000000C0011111
111111000000000000000000111111
111111000001111111000000111111
111111000000000000000000111111
111111111111100011111111111111
111110000000000000000000011111
100010000000011100000000010001
10111000000001E100000000011101
100000000000000000000000000001
100000000000000000000000000001
111111111111110111111111111111
111111111000110110001111111111
111111111010000000101111111111
11111111101111X111101111111111
111111111011111111101111111111
111111111C111111111C1111111111
111111111111111111111111111111