111111111111
1E00000011P1
10C000000001
100001111111
100100010001
1C00010001C1
111111111111