111111111111111111111111111111111111111111
100000000000000000000000000000000000000001
100000000000000000000C00000000000000000001
10000000000E000000000000000000000C00000001
1000C0000000000000000000000000P00000000001
100000000000000000000000000000000000000001
10000000C000000000000000000000000000000001
10000000000000000000C000000000000000000001
100000000000000000000000000000000000000001
100000000000000000001111000000000000000001
100000000000000000000000000000000000000001
100000000000000000000000000000000000000001
111111111111111111111111111111111111111111