11111111111111111111111111111111111111111111111111111111111111111111111111111111111
10000000000000000000000000000000000000000000000000000000000000000000000000000000001
100000000000000000000C0000000000000000000011111111111111111111111111111111111111001
10000000000E000000000000000000000C0000000000000000000000000000000000000000000000001
1000C0000000000000000000000000P0000000000011111111111111111111111111111111111110001
10000000000000000000000000000000000000000000000000000000000000000000000000000000001
10000000C00000000000000000000000000000000011111111111111111111111111111111111111001
10000000000000000000C00000000000000000000000000000000000000000000000000000000000001
10000000000000000000000000000000000000000011111111111111111111111111111111111110001
10000000000000000000111100000000000000000000000000000000000000000000000000000000001
10000000000000000000000000000000000000000011111111111111111111111111111111111110001
10000000000000000000000000000000000000000000000000000000000000000000000000000000001
10001111111111111111111111111111111111111111111111111111111111111111111111111110001
10000000000000000000000000000000000000000000000000000000000000000000000000000000001
10000000C0000000000000000000000000000C000011111111111111111111111111111111111110001
1000000000C000000000000000000000000C00000000000000000000000000000000000000000000001
100000000000CCCCCCCCCCCCCCCCCCCCCC0000000011111111111111111111111111111111111110001
10000000000000000000000000000000000000000000000000000000000000000000000000000000001
10000000000000000000000000000000000000000011111111111111111111111111111111111110001
10000000000000000000000000000000000000000011111111111111111111111111111111111110001
10000000000000000000000000000000000000000000000000000000000000000000000000000000001
10000000000000000000000000000000000000000011111111111111111111111111111111111110001
10000000000000000000000000000000000000000000000000000000000000000000000000000000001
10000000000000000000000000000000000000000011111111111111111111111111111111111110001
10000000000000000000000000000000000000000000000000000000000000000000000000000000001
10000000000000000000000000000000000000000011111111111111111111111111111111111110001
10000000000000000000000000000000000000000011111111111111111111111111111111111110001
10000000000000000000000000000000000000000000000000000000000000000000000000000000001
11111111111111111111111111111111111111111111111111111111111111111111111111111111111
10000000000000000000000000000000000000000011111111111111111111111111111111111110001
10000000000000000000000000000000000000000000000000000000000000000000000000000000001
10000000000000000000000000000000000000000011111111111111111111111111111111111110001
10000000000000000000000000000000000000000011111111111111111111111111111111111110001
10000000000000000000000000000000000000000000000000000000000000000000000000000000001
11111111111111111111111111111111111111111111111111111111111111111111111111111111111
10000000000000000000000000000000000000000011111111111111111111111111111111111110001
10000000000000000000000000000000000000000000000000000000000000000000000000000000001
10000000000000000000000000000000000000000011111111111111111111111111111111111110001
10000000000000000000000000000000000000000011111111111111111111111111111111111110001
10000000000000000000000000000000000000000000000000000000000000000000000000000000001
11111111111111111111111111111111111111111111111111111111111111111111111111111111111