111111111111
1E00000011P1
10C000000001
100001111111
100100010001
1X00010001X1
111111111111